1,1,1,1,1,1,1,1,1,1,1,1,1,1,1,1,1,1,1,1,1,1,1,1,1,1,1,1,1,1,1,1,1,1,1,1,1,1,1,1,1,1,1,1,1,1,1,1,1,1,1,1,1,1,1,1,1,1,1,1,1,1,1,1,1,1,1,1,1,1,1,1,1,1,1,1,1,1,1,1,1,1,1,1,1,1,1,1,1,1,1,1,1,1,1,1,1,1,1,1,1,1,1,1,1,1,1,1,1,1,1,1,1,1,1,1,1,1,1,1,1,1,1,1,1,1,1,1,1,1,
1,1,1,1,1,1,1,1,1,1,1,1,1,1,1,1,1,1,1,1,1,1,1,1,1,1,1,1,1,1,1,1,1,1,1,1,1,1,1,1,1,1,1,1,1,1,1,1,1,1,1,1,1,1,1,1,1,1,1,1,1,1,1,1,1,1,1,1,1,1,1,1,1,1,1,1,1,1,1,1,1,1,1,1,1,1,1,1,1,1,1,1,1,1,1,1,1,1,1,1,1,1,1,1,1,1,1,1,1,1,1,1,1,1,1,1,1,1,1,1,1,1,1,1,1,1,1,1,1,1,
1,1,1,1,1,1,1,1,1,1,1,1,1,1,1,1,1,1,1,1,1,1,1,1,1,1,1,1,1,1,1,1,1,1,1,1,1,1,1,1,1,1,1,1,1,1,1,1,1,1,1,1,1,1,1,1,1,1,1,1,1,1,1,1,1,1,1,1,1,1,1,1,1,1,1,1,1,1,1,1,1,1,1,1,1,1,1,1,1,1,1,1,1,1,1,1,1,1,1,1,1,1,1,1,1,1,1,1,1,1,1,1,1,1,1,1,1,1,1,1,1,1,1,1,1,1,1,1,1,1,
1,1,1,1,1,1,1,1,1,1,1,1,1,1,1,1,1,1,1,1,1,1,1,1,1,1,1,1,1,1,1,1,1,1,1,1,1,1,1,1,1,1,1,1,1,1,1,1,1,1,1,1,1,1,1,1,1,1,1,1,1,1,1,1,1,1,1,1,1,1,1,1,1,1,1,1,1,1,1,1,1,1,1,1,1,1,1,1,1,1,1,1,1,1,1,1,1,1,1,1,1,1,1,1,1,1,1,1,1,1,1,1,1,1,1,1,1,1,1,1,1,1,1,1,1,1,1,1,1,1,
1,1,1,1,1,1,1,1,1,1,1,1,1,1,1,1,1,1,1,1,1,1,1,1,1,1,1,1,1,1,1,1,1,1,1,1,1,1,1,1,1,1,1,1,1,1,1,1,1,1,1,1,1,1,1,1,1,1,1,1,1,1,1,1,1,1,1,1,1,1,1,1,1,1,1,1,1,1,1,1,1,1,1,1,1,1,1,1,1,1,1,1,1,1,1,1,1,1,1,1,1,1,1,1,1,1,1,1,1,1,1,1,1,1,1,1,1,1,1,1,1,1,1,1,1,1,1,1,1,1,
5,6,5,5,6,5,6,5,6,5,6,6,6,5,5,5,6,5,5,5,6,5,6,5,5,5,5,6,6,5,6,5,6,6,5,5,5,5,6,6,5,6,5,5,6,5,6,5,7,1,1,1,1,1,1,1,1,1,1,1,1,1,1,1,1,1,1,1,1,1,1,1,1,1,1,1,1,1,1,1,1,1,1,1,1,1,1,1,1,1,1,1,1,1,1,1,1,1,1,1,1,1,1,1,1,1,1,1,1,1,1,1,1,1,1,1,1,1,1,1,1,1,1,1,1,1,1,1,1,1,1,1,
2,2,34,3,3,3,2,34,3,3,34,3,2,3,2,2,2,3,2,3,2,2,2,2,35,2,2,3,2,2,3,2,3,2,3,2,2,2,3,2,2,3,2,3,3,2,3,2,3,7,5,6,5,6,5,6,5,6,6,6,5,5,5,6,5,5,5,6,5,6,5,5,5,5,6,6,5,6,5,6,6,5,5,5,5,6,6,5,6,5,5,6,5,6,5,5,5,6,5,5,6,5,6,5,6,5,6,6,6,5,5,5,6,5,5,5,6,5,6,5,5,5,5,6,6,5,6,5,6,6,5,5,5,5,6,6,5,6,5,5,6,5,
3,3,3,2,3,2,3,2,3,2,3,2,2,35,3,3,2,3,3,3,2,3,2,2,3,3,2,3,2,3,3,2,35,2,3,2,2,2,3,2,3,3,2,3,2,3,2,2,2,3,2,3,2,2,2,3,2,3,3,2,3,2,3,3,2,3,2,35,2,3,2,3,2,3,3,2,3,2,3,2,3,2,2,3,2,3,2,3,2,3,3,2,3,2,3,2,2,2,2,3,2,2,2,3,2,3,35,2,3,2,3,2,2,2,3,2,2,2,3,2,3,3,2,3,2,3,2,2,2,34,3,2,3,2,
2,2,3,2,3,3,2,3,3,2,3,2,3,3,2,34,2,3,2,3,2,2,3,2,3,3,2,34,3,2,3,2,3,2,3,2,3,3,2,34,2,3,34,3,2,3,2,3,2,3,3,2,2,2,3,2,3,3,2,3,2,3,2,3,2,2,3,2,3,2,3,2,3,3,2,2,2,3,2,3,3,2,3,2,2,2,3,2,35,3,2,3,2,3,2,2,2,2,3,2,2,2,3,2,3,3,2,3,2,3,2,2,2,3,2,2,2,3,2,3,3,2,3,2,3,2,2,2,35,2,3,2,3,2,
3,3,3,35,3,2,2,2,3,3,3,3,3,3,2,3,3,3,2,3,2,2,2,3,3,2,2,3,2,3,3,2,34,2,3,2,2,2,3,3,2,2,35,2,3,3,2,2,3,2,3,2,2,2,34,2,3,3,2,3,2,2,2,2,2,2,3,2,2,2,3,2,3,3,2,3,2,3,2,3,2,2,34,2,3,2,3,3,3,3,2,3,2,3,2,3,2,3,2,2,2,2,3,2,3,3,2,3,2,34,3,2,2,3,2,2,2,3,2,3,3,2,3,2,34,2,2,2,3,2,35,2,3,
2,2,2,3,3,34,3,2,3,2,3,2,2,3,3,35,2,3,35,3,2,3,3,34,3,3,2,3,3,2,3,2,35,2,3,2,3,3,2,3,3,2,3,3,2,2,34,35,2,3,2,2,2,3,2,35,3,2,3,2,3,2,2,2,34,3,2,2,2,3,2,2,3,2,2,2,3,2,3,3,2,3,2,2,3,3,3,3,35,2,3,2,3,2,3,2,2,3,2,2,2,34,3,3,3,3,3,2,3,3,2,34,3,2,2,2,3,2,3,3,2,35,2,3,2,2,2,3,3,2,3,
3,2,3,2,3,2,3,2,3,2,3,2,2,3,2,3,2,3,2,3,2,3,2,3,3,3,2,3,2,3,3,2,3,2,3,35,2,3,2,2,2,3,2,3,3,2,3,2,3,2,2,2,2,3,2,2,2,3,2,3,3,2,2,2,3,2,2,2,2,3,2,2,3,34,2,3,3,2,3,2,3,3,2,2,2,3,2,2,2,3,2,3,2,3,34,2,2,2,3,2,3,3,3,3,3,2,3,2,3,3,2,3,2,3,2,34,3,2,3,2,3,2,3,3,2,3,2,3,2,3,2,2,3,2,3,2,
15,16,15,15,16,15,15,15,16,16,15,15,15,15,16,16,15,15,16,16,15,15,15,15,17,12,12,36,2,3,2,35,2,3,2,3,3,3,2,2,3,2,2,2,3,2,3,3,2,2,2,3,2,3,3,3,2,34,2,2,34,34,3,3,2,2,14,15,15,16,17,3,3,2,3,2,2,3,35,2,2,3,3,2,3,2,3,2,3,2,3,2,2,14,16,15,15,16,15,15,15,15,15,15,16,17,15,16,15,16,15,15,15,16,15,16,15,15,15,15,15,15,16,15,16,15,15,15,15,15
1,1,1,1,1,1,1,1,1,1,1,1,1,1,1,1,1,1,1,1,1,1,1,1,1,1,1,8,2,2,3,2,3,2,3,3,2,3,2,34,3,2,2,3,2,3,2,3,2,3,3,2,37,11,14,15,16,15,15,15,16,15,16,15,17,11,11,11,11,11,11,11,11,14,15,15,16,15,15,15,15,16,15,15,17,11,11,14,15,15,15,17,11,11,11,11,11,11,11,11,11,11,11,11,11,11,11,11,11,11,11,11,11,11,11,11,11,11,11,11,11,11,11,11,11,11,11,11,11,11,11,11,11,11
1,1,1,1,1,1,1,1,1,1,1,1,1,1,1,1,1,1,1,1,1,1,1,1,1,1,1,14,16,15,15,16,15,16,15,16,16,15,16,16,15,15,15,15,15,15,16,15,16,16,15,15,17,1,1,1,1,1,1,1,1,1,1,1,1,1,1,1,1,1,1,1,1,1,1,1,1,1,1,1,1,1,1,1,1,1,1,1,1,1,1,1,1,1,1,1,1,1,1,1,1,1,1,1,1,1,1,1,1,1,1,1,1,1,1,1,1,1,1,1,1,1,1,1,1,1,1,1,1,1,
1,1,1,1,1,1,1,1,1,1,1,1,1,1,1,1,1,1,1,1,1,1,1,1,1,1,1,1,1,1,1,1,1,1,1,1,1,1,1,1,1,1,1,1,1,1,1,1,1,1,1,1,1,1,1,1,1,1,1,1,1,1,1,1,1,1,1,1,1,1,1,1,1,1,1,1,1,1,1,1,1,1,1,1,1,1,1,1,1,1,1,1,1,1,1,1,1,1,1,1,1,1,1,1,1,1,1,1,1,1,1,1,1,1,1,1,1,1,1,1,1,1,1,1,1,1,1,1,1,1,1,1,1,1,1,1,1,1,1,1,1,